222222222222222
271111111111112
212121212121212
211111111111112
212121212121212
211111111111112
212121212121212
211111111111112
212121212121212
211111111111112
212121212121212
211111111111112
222222222222222
